111111111111111111111111111111111111
100000000000000000000000000000000001
100000000000000000000000000000000001
100220022002200220022002200220022001
100220022002200220022002200220022001
100220022002200221122002200220022001
100220022002200221122002200220022001
100220022002200220022002200220022001
100000000000000220022000000000000001
100000000000000220022000000000000001
111002222222200000000002222222200111
122002222222200000000002222222200221
100000000000000220022000000000000001
100000000000000222222000000000000001
100220022002200222222002200220022001
100220022002200220022002200220022001
100220022002200000000002200220022001
100220022002200000000002200220022001
100220022002200022220002200220022001
100000000000003020020000000000000001
100000000000000020020000000000000001
111111111111111111111111111111111111
111111111111111111111111111111111111
111111111111111111111111111111111111